WWWWWWWWWWWWWWW
Wh  w wBwwww dW
W WwWwWwWwWwW W
Ww  w wBw swwwW
WbWwW WBWwWbW W
Www B   w w B W
WwWwW W W W WwW
Ww  wB f w BwwW
WwWwWwWwWdWwWwW
W www B wwwwwwW
W WwW W W WwWwW
Ww Bw  Bw www W
W WwW WwW WwW W
WfB  w    w B W
WWWWWWWWWWWWWW
