WWWWWWWWWWWWWWW
Wh    w ww    W
W WwWwWwWwW W W
W w w w w wwwwW
W W W WwWwWbWwW
Www     w w R W
WwW WwW W WwWwW
Ww  wwwfww  wwW
W W W W W W WwW
W www      w wW
W WfW W W WwWwW
Ws  w  Rw  wwwW
W W W W W WdW W
WbR       w   W
WWWWWWWWWWWWWWW
