WWWWWWWWWWWWWWW
Wh  wRw wwww  W
W WwWRWwWwWwW W
Wwwf  w w wwwwW
WBWwW W W WBWwW
Wwwww   w w   W
W W WwW W W WwW
Ww  w wfww  wwW
W W W W WwW WsW
W www   www wbW
W WwW W W WwW W
Wd  w  Rw wwwwW
W W WwWwW WwW W
W         b   W
WWWWWWWWWWWWWWW
