WWWWWWWWWWWWWWW
Wh   wR wwww  W
W WBWwWwWwWwW W
Www wdwBw wwwwW
W WwWwWwWwWbWwW
W wwwB  w w R W
WRWwWwWwWwWwWdW
Ww Rwwwfww  wwW
WsWwWwWwW WbWwW
W www B wwwwwwW
W WwW W W WfWwW
WwB w  Rw wwwwW
W WwWwWwW WwW W
W R   wwwRw   W
WWWWWWWWWWWWWWW
