WWWWWWWWWWWWWWW
Wh       R    W
W WWWW   WWWW W
W W    B    W W
W W W WWW W W W
W W WR   BW W W
W   W W W W   W
WR  W  d  W  RW
W   W W W W   W
W W WB   RW W W
W W W WWW W W W
W W    R    W W
W WWWW   WWWW W
W           W W
WWWWWWWWWWWWWWW
